000: 00000424 - 00000000000000000000010000100100
004: 00000424 - 00000000000000000000010000100100
008: 00000424 - 00000000000000000000010000100100
00c: 00000424 - 00000000000000000000010000100100
010: 00000424 - 00000000000000000000010000100100
014: 00000424 - 00000000000000000000010000100100
018: 00000424 - 00000000000000000000010000100100
01c: 00000424 - 00000000000000000000010000100100
020: 00000424 - 00000000000000000000010000100100
024: 00000424 - 00000000000000000000010000100100
028: 00000424 - 00000000000000000000010000100100
02c: 00000424 - 00000000000000000000010000100100
030: 00000424 - 00000000000000000000010000100100
034: 00000424 - 00000000000000000000010000100100
038: 00000424 - 00000000000000000000010000100100
03c: 00000428 - 00000000000000000000010000101000
040: 00000000 - 00000000000000000000000000000000
044: 00000000 - 00000000000000000000000000000000
048: 00000048 - 00000000000000000000000001001000
04c: 00000065 - 00000000000000000000000001100101
050: 0000006c - 00000000000000000000000001101100
054: 0000006c - 00000000000000000000000001101100
058: 0000006f - 00000000000000000000000001101111
05c: 00000020 - 00000000000000000000000000100000
060: 00000057 - 00000000000000000000000001010111
064: 0000006f - 00000000000000000000000001101111
068: 00000072 - 00000000000000000000000001110010
06c: 0000006c - 00000000000000000000000001101100
070: 00000064 - 00000000000000000000000001100100
074: 00000000 - 00000000000000000000000000000000
078: 00000080 - 00000000000000000000000010000000
07c: 00000080 - 00000000000000000000000010000000
080: 00000000 - 00000000000000000000000000000000
084: 00000000 - 00000000000000000000000000000000
088: 00000000 - 00000000000000000000000000000000
08c: 00000000 - 00000000000000000000000000000000
090: 00000000 - 00000000000000000000000000000000
094: 00000000 - 00000000000000000000000000000000
098: 00000000 - 00000000000000000000000000000000
09c: 00000000 - 00000000000000000000000000000000
0a0: 00000000 - 00000000000000000000000000000000
0a4: 00000000 - 00000000000000000000000000000000
0a8: 00000000 - 00000000000000000000000000000000
0ac: 00000000 - 00000000000000000000000000000000
0b0: 00000000 - 00000000000000000000000000000000
0b4: 00000000 - 00000000000000000000000000000000
0b8: 00000000 - 00000000000000000000000000000000
0bc: 00000000 - 00000000000000000000000000000000
0c0: 00000000 - 00000000000000000000000000000000
0c4: 00000000 - 00000000000000000000000000000000
0c8: 00000000 - 00000000000000000000000000000000
0cc: 00000000 - 00000000000000000000000000000000
0d0: 00000000 - 00000000000000000000000000000000
0d4: 00000000 - 00000000000000000000000000000000
0d8: 00000000 - 00000000000000000000000000000000
0dc: 00000000 - 00000000000000000000000000000000
0e0: 00000000 - 00000000000000000000000000000000
0e4: 00000000 - 00000000000000000000000000000000
0e8: 00000000 - 00000000000000000000000000000000
0ec: 00000000 - 00000000000000000000000000000000
0f0: 00000000 - 00000000000000000000000000000000
0f4: 00000000 - 00000000000000000000000000000000
0f8: 00000000 - 00000000000000000000000000000000
0fc: 00000000 - 00000000000000000000000000000000
100: 00000000 - 00000000000000000000000000000000
104: 00000000 - 00000000000000000000000000000000
108: 00000000 - 00000000000000000000000000000000
10c: 00000000 - 00000000000000000000000000000000
110: 00000000 - 00000000000000000000000000000000
114: 00000000 - 00000000000000000000000000000000
118: 00000000 - 00000000000000000000000000000000
11c: 00000000 - 00000000000000000000000000000000
120: 00000000 - 00000000000000000000000000000000
124: 00000000 - 00000000000000000000000000000000
128: 00000000 - 00000000000000000000000000000000
12c: 00000000 - 00000000000000000000000000000000
130: 00000000 - 00000000000000000000000000000000
134: 00000000 - 00000000000000000000000000000000
138: 00000000 - 00000000000000000000000000000000
13c: 00000000 - 00000000000000000000000000000000
140: 00000000 - 00000000000000000000000000000000
144: 00000000 - 00000000000000000000000000000000
148: 00000000 - 00000000000000000000000000000000
14c: 00000000 - 00000000000000000000000000000000
150: 00000000 - 00000000000000000000000000000000
154: 00000000 - 00000000000000000000000000000000
158: 00000000 - 00000000000000000000000000000000
15c: 00000000 - 00000000000000000000000000000000
160: 00000000 - 00000000000000000000000000000000
164: 00000000 - 00000000000000000000000000000000
168: 00000000 - 00000000000000000000000000000000
16c: 00000000 - 00000000000000000000000000000000
170: 00000000 - 00000000000000000000000000000000
174: 00000000 - 00000000000000000000000000000000
178: 00000000 - 00000000000000000000000000000000
17c: 00000000 - 00000000000000000000000000000000
180: 00000000 - 00000000000000000000000000000000
184: 00000000 - 00000000000000000000000000000000
188: 00000000 - 00000000000000000000000000000000
18c: 00000000 - 00000000000000000000000000000000
190: 00000000 - 00000000000000000000000000000000
194: 00000000 - 00000000000000000000000000000000
198: 00000000 - 00000000000000000000000000000000
19c: 00000000 - 00000000000000000000000000000000
1a0: 00000000 - 00000000000000000000000000000000
1a4: 00000000 - 00000000000000000000000000000000
1a8: 00000000 - 00000000000000000000000000000000
1ac: 00000000 - 00000000000000000000000000000000
1b0: 00000000 - 00000000000000000000000000000000
1b4: 00000000 - 00000000000000000000000000000000
1b8: 00000000 - 00000000000000000000000000000000
1bc: 00000000 - 00000000000000000000000000000000
1c0: 00000000 - 00000000000000000000000000000000
1c4: 00000000 - 00000000000000000000000000000000
1c8: 00000000 - 00000000000000000000000000000000
1cc: 00000000 - 00000000000000000000000000000000
1d0: 00000000 - 00000000000000000000000000000000
1d4: 00000000 - 00000000000000000000000000000000
1d8: 00000000 - 00000000000000000000000000000000
1dc: 00000000 - 00000000000000000000000000000000
1e0: 00000000 - 00000000000000000000000000000000
1e4: 00000000 - 00000000000000000000000000000000
1e8: 00000000 - 00000000000000000000000000000000
1ec: 00000000 - 00000000000000000000000000000000
1f0: 00000000 - 00000000000000000000000000000000
1f4: 00000000 - 00000000000000000000000000000000
1f8: 00000000 - 00000000000000000000000000000000
1fc: 00000000 - 00000000000000000000000000000000
200: 00000000 - 00000000000000000000000000000000
204: 00000000 - 00000000000000000000000000000000
208: 00000000 - 00000000000000000000000000000000
20c: 00000000 - 00000000000000000000000000000000
210: 00000000 - 00000000000000000000000000000000
214: 00000000 - 00000000000000000000000000000000
218: 00000000 - 00000000000000000000000000000000
21c: 00000000 - 00000000000000000000000000000000
220: 00000000 - 00000000000000000000000000000000
224: 00000000 - 00000000000000000000000000000000
228: 00000000 - 00000000000000000000000000000000
22c: 00000000 - 00000000000000000000000000000000
230: 00000000 - 00000000000000000000000000000000
234: 00000000 - 00000000000000000000000000000000
238: 00000000 - 00000000000000000000000000000000
23c: 00000000 - 00000000000000000000000000000000
240: 00000000 - 00000000000000000000000000000000
244: 00000000 - 00000000000000000000000000000000
248: 00000000 - 00000000000000000000000000000000
24c: 00000000 - 00000000000000000000000000000000
250: 00000000 - 00000000000000000000000000000000
254: 00000000 - 00000000000000000000000000000000
258: 00000000 - 00000000000000000000000000000000
25c: 00000000 - 00000000000000000000000000000000
260: 00000000 - 00000000000000000000000000000000
264: 00000000 - 00000000000000000000000000000000
268: 00000000 - 00000000000000000000000000000000
26c: 00000000 - 00000000000000000000000000000000
270: 00000000 - 00000000000000000000000000000000
274: 00000000 - 00000000000000000000000000000000
278: 00000000 - 00000000000000000000000000000000
27c: 00000000 - 00000000000000000000000000000000
280: 00000000 - 00000000000000000000000000000000
284: 00000000 - 00000000000000000000000000000000
288: 00000000 - 00000000000000000000000000000000
28c: 00000000 - 00000000000000000000000000000000
290: 00000000 - 00000000000000000000000000000000
294: 00000000 - 00000000000000000000000000000000
298: 00000000 - 00000000000000000000000000000000
29c: 00000000 - 00000000000000000000000000000000
2a0: 00000000 - 00000000000000000000000000000000
2a4: 00000000 - 00000000000000000000000000000000
2a8: 00000000 - 00000000000000000000000000000000
2ac: 00000000 - 00000000000000000000000000000000
2b0: 00000000 - 00000000000000000000000000000000
2b4: 00000000 - 00000000000000000000000000000000
2b8: 00000000 - 00000000000000000000000000000000
2bc: 00000000 - 00000000000000000000000000000000
2c0: 00000000 - 00000000000000000000000000000000
2c4: 00000000 - 00000000000000000000000000000000
2c8: 00000000 - 00000000000000000000000000000000
2cc: 00000000 - 00000000000000000000000000000000
2d0: 00000000 - 00000000000000000000000000000000
2d4: 00000000 - 00000000000000000000000000000000
2d8: 00000000 - 00000000000000000000000000000000
2dc: 00000000 - 00000000000000000000000000000000
2e0: 00000000 - 00000000000000000000000000000000
2e4: 00000000 - 00000000000000000000000000000000
2e8: 00000000 - 00000000000000000000000000000000
2ec: 00000000 - 00000000000000000000000000000000
2f0: 00000000 - 00000000000000000000000000000000
2f4: 00000000 - 00000000000000000000000000000000
2f8: 00000000 - 00000000000000000000000000000000
2fc: 00000000 - 00000000000000000000000000000000
300: 00000000 - 00000000000000000000000000000000
304: 00000000 - 00000000000000000000000000000000
308: 00000000 - 00000000000000000000000000000000
30c: 00000000 - 00000000000000000000000000000000
310: 00000000 - 00000000000000000000000000000000
314: 00000000 - 00000000000000000000000000000000
318: 00000000 - 00000000000000000000000000000000
31c: 00000000 - 00000000000000000000000000000000
320: 00000000 - 00000000000000000000000000000000
324: 00000000 - 00000000000000000000000000000000
328: 00000000 - 00000000000000000000000000000000
32c: 00000000 - 00000000000000000000000000000000
330: 00000000 - 00000000000000000000000000000000
334: 00000000 - 00000000000000000000000000000000
338: 00000000 - 00000000000000000000000000000000
33c: 00000000 - 00000000000000000000000000000000
340: 00000000 - 00000000000000000000000000000000
344: 00000000 - 00000000000000000000000000000000
348: 00000000 - 00000000000000000000000000000000
34c: 00000000 - 00000000000000000000000000000000
350: 00000000 - 00000000000000000000000000000000
354: 00000000 - 00000000000000000000000000000000
358: 00000000 - 00000000000000000000000000000000
35c: 00000000 - 00000000000000000000000000000000
360: 00000000 - 00000000000000000000000000000000
364: 00000000 - 00000000000000000000000000000000
368: 00000000 - 00000000000000000000000000000000
36c: 00000000 - 00000000000000000000000000000000
370: 00000000 - 00000000000000000000000000000000
374: 00000000 - 00000000000000000000000000000000
378: 00000000 - 00000000000000000000000000000000
37c: 00000000 - 00000000000000000000000000000000
380: 00000000 - 00000000000000000000000000000000
384: 00000000 - 00000000000000000000000000000000
388: 00000000 - 00000000000000000000000000000000
38c: 00000000 - 00000000000000000000000000000000
390: 00000000 - 00000000000000000000000000000000
394: 00000000 - 00000000000000000000000000000000
398: 00000000 - 00000000000000000000000000000000
39c: 00000000 - 00000000000000000000000000000000
3a0: 00000000 - 00000000000000000000000000000000
3a4: 00000000 - 00000000000000000000000000000000
3a8: 00000000 - 00000000000000000000000000000000
3ac: 00000000 - 00000000000000000000000000000000
3b0: 00000000 - 00000000000000000000000000000000
3b4: 00000000 - 00000000000000000000000000000000
3b8: 00000000 - 00000000000000000000000000000000
3bc: 00000000 - 00000000000000000000000000000000
3c0: 00000000 - 00000000000000000000000000000000
3c4: 00000000 - 00000000000000000000000000000000
3c8: 00000000 - 00000000000000000000000000000000
3cc: 00000000 - 00000000000000000000000000000000
3d0: 00000000 - 00000000000000000000000000000000
3d4: 00000000 - 00000000000000000000000000000000
3d8: 00000000 - 00000000000000000000000000000000
3dc: 00000000 - 00000000000000000000000000000000
3e0: 00000000 - 00000000000000000000000000000000
3e4: 00000000 - 00000000000000000000000000000000
3e8: 00000000 - 00000000000000000000000000000000
3ec: 00000000 - 00000000000000000000000000000000
3f0: 00000000 - 00000000000000000000000000000000
3f4: 00000000 - 00000000000000000000000000000000
3f8: 00000000 - 00000000000000000000000000000000
3fc: 00000000 - 00000000000000000000000000000000
400: 00048b71 - 00000000000001001000101101110001
404: 00000b70 - 00000000000000000000101101110000
408: 00016bd2 - 00000000000000010110101111010010
40c: 00000bf2 - 00000000000000000000101111110010
410: 00000811 - 00000000000000000000100000010001
414: 00044b81 - 00000000000001000100101110000001
418: 00004b72 - 00000000000000000100101101110010
41c: fffff610 - 11111111111111111111011000010000
420: 00000031 - 00000000000000000000000000110001
424: 00000030 - 00000000000000000000000000110000
428: 000787f1 - 00000000000001111000011111110001
42c: 000007f0 - 00000000000000000000011111110000
430: 0000f7d2 - 00000000000000001111011111010010
434: 00040700 - 00000000000001000000011100000000
438: 0000f753 - 00000000000000001111011101010011
43c: 000047f2 - 00000000000000000100011111110010
440: 00078781 - 00000000000001111000011110000001
444: 00000030 - 00000000000000000000000000110000
448: 00000000 - 00000000000000000000000000000000
